17 27
2 3
0 0 0 0 0 0 0 0 0
0 0 0 0 0
0 0 1000
0 0 0 0
0
0  0 0 0 0 0 0 0 0 0 0 0 0 0 0 0  0
0  0 0 0 0 0 0 0 0 0 0 0 0 0 0 0  0
0  0 0 0 0 0 0 0 0 0 0 0 0 0 0 0  0
0  0 0 0 0 0 0 0 0 0 0 0 0 0 0 0  0
0  0 0 0 0 0 0 0 0 0 0 0 0 0 0 0  0
1  3 0 0 0 0 0 0 0 0 0 0 0 0 0 0  0
4  6 0 0 0 0 0 0 0 0 0 0 0 0 0 0  0
4 17 3 0 0 0 0 0 0 0 0 0 0 0 0 0  0
4 5  6 0 0 0 0 0 0 0 0 0 0 0 0 0  0
4 5 17 3 0 0 0 0 0 0 0 0 0 0 0 0  0
4 5 5  6 0 0 0 0 0 0 0 0 0 0 0 0  0
4 5 5 17 3 0 0 0 0 0 0 0 0 0 0 0  0
4 5 5 5  6 0 0 0 0 0 0 0 0 0 0 0  0
4 5 5 5 17 3 0 0 0 0 0 0 0 0 0 0  0
4 5 5 5 5  6 0 0 0 0 0 0 0 0 0 0  0 
4 5 5 5 5 17 3 0 0 0 0 0 0 0 0 0  0
4 5 5 5 5 5  6 0 0 0 0 0 0 0 0 0  0
4 5 5 5 5 5 17 3 0 0 0 0 0 0 0 0  0
4 5 5 5 5 5 5  6 0 0 0 0 0 0 0 0  0
4 5 5 5 5 5 5 17 3 0 0 0 0 0 0 2 18
4 5 5 5 5 5 5 5  6 0 0 0 0 0 0 4  0
4 5 5 5 5 5 5 5 17 3 0 0 0 0 2 18 0
4 5 5 5 5 5 5 5 5  6 0 0 0 0 4  0 0
4 5 5 5 5 5 5 5 5 17 3 0 0 2 18 0 0
4 5 5 5 5 5 5 5 5 5  6 0 0 4  0 0 0
4 5 5 5 5 5 5 5 5 5 17 2 2 18 0 0 0
7 8 8 8 8 8 8 8 8 8 8  9 7  8 8 8 8 8 8 8 8 8 8  9
