25 21
0 1
0 0 0 0 0 0 0 0 0
0 0 0 0 0 0
0 0 0
0 0 0 0
0 0 10000
0 0 0 0
0
0 0 0 0 0 0 0 0 0 0 0 0 0 0 0 0 0 0 0 0 0 0 0 0 0 
1 2 2 2 3 0 0 0 0 0 0 0 0 0 0 0 0 0 0 0 1 2 2 2 3 
4 5 5 5 6 0 0 0 0 0 0 0 0 0 0 0 0 0 0 0 4 5 5 5 6
4 5 5 5 6 0 0 0 0 0 0 0 0 0 0 0 0 0 0 0 4 5 5 5 6
4 5 5 5 6 0 0 0 0 0 0 0 0 0 0 0 0 0 0 0 4 5 5 5 6
4 5 5 5 6 0 0 0 0 0 0 0 0 0 0 0 0 0 0 0 4 5 5 5 6 
4 5 5 5 6 0 0 0 0 0 0 0 0 0 0 0 0 0 0 0 4 5 5 5 6 
4 5 5 5 6 0 0 0 0 0 0 0 0 0 0 0 0 0 0 0 4 5 5 5 6
4 5 5 5 6 0 0 0 0 0 0 0 0 0 0 0 0 0 0 0 4 5 5 5 6 
4 5 5 5 6 0 0 0 0 0 0 0 0 0 0 0 0 0 0 0 4 5 5 5 6 
4 5 5 5 6 0 0 0 0 0 0 0 0 0 0 0 0 0 0 0 4 5 5 5 6
4 5 5 5 6 0 0 0 0 0 0 0 0 0 0 0 0 0 0 0 4 5 5 5 6 
4 5 5 5 6 0 0 0 0 0 0 0 0 0 0 0 0 0 0 0 4 5 5 5 6 
4 5 5 5 6 0 0 0 0 0 0 0 0 0 0 0 0 0 0 0 4 5 5 5 6 
4 5 5 5 6 0 0 0 0 0 0 0 0 0 0 0 0 0 0 0 4 5 5 5 6 
4 5 5 5 6 0 0 0 0 0 0 0 0 0 0 0 0 0 0 0 4 5 5 5 6 
4 5 5 5 6 0 0 0 0 0 0 0 0 0 0 0 0 0 0 0 4 5 5 5 6 
4 5 5 5 6 0 0 0 0 0 0 0 0 0 0 0 0 0 0 0 4 5 5 5 6 
4 5 5 5 6 0 0 0 0 0 0 0 0 0 0 0 0 0 0 0 4 5 5 5 6 
4 5 5 5 17 2 2 2 2 2 2 2 2 2 2 2 2 2 2 2 18 5 5 5 6 
7 8 8 8 8 8 8 8 8 8 8 8 8 8 8 8 8 8 8 8 8 8 8 8 9 
Water 5 1 15 18 0 0