31 11
1 0
0 0 0 0 0 0 0 0 0
0 0 0 0 0
0 0 1000
0 0 0 0
0
0 0 0 0  0 0 0 0  0 0 0 0 0 0  0 0 0  0  0  0  0  0  0  0 0 0 0 0 0 0 0
0 0 0 0  0 0 0 0  0 0 0 0 0 0  0 0 0  0  0  0  0  0  0  0 0 0 0 0 0 0 0
0 0 0 0  0 0 0 0  0 0 0 0 0 0  0 0 0  0  0  0  0  0  0  0 0 0 0 0 0 0 0
0 0 0 0  0 0 0 0  0 0 0 0 0 0  0 0 0  0  0  0  0  0  0  0 0 0 0 0 0 0 0
0 0 0 0  0 0 0 0  0 0 0 0 0 0  0 0 0  0  34 0  0  0  0  0 0 0 0 0 0 0 0
0 0 0 21 0 0 0 0  0 0 0 0 0 0  0 0 0  0  23 0  0  0  0  0 0 0 0 0 0 0 0
16 1 2 2 3 0 0 1  2 2 3 0 0 13 0 0 10 11 11 11 11 11 12 0 0 0 0 0 0 0 16
0 4 5 5 6 29 22 4 5 5 6 10 11 11 11 12 0 0 0 0 0  0  0  0 0 0 0 0 0 0 0
0 4 5 5 17 2 2 18 5 5 6 0 0 0  0 0 0  0  0  0  0  0  0  0 0 0 0 0 0 0 0
0 7 8 8 8  8 8 8  8 8 9 0 0 0  0 0 0  0  0  0  0  0  0  0 0 0 0 0 0 0 0
16 0 0 0 0 0 0 0  0 0 0 0 0 0  0 0 0  0  0  0  0  0  0  0 0 0 0 0 0 0 0